
NO textures/hello.xpm
WE textures/hello.xpm
EA textures/hello.xpm
SO textures/hello.xpm

C 200,100,0,
F 255,30,0


11111111111
11000000001
11000001001
1000E000001
11111111111
