C 104,17,17
F 84,84,84

NO ./assets/lavawall1.xpm
SO ./assets/lavawall4.xpm
EA ./assets/lavawall2.xpm
WE ./assets/lavawall3.xpm

111111111111
100000000001
100000000001
100000000001
100001000001
100000000001
10000S000001
100000000001
100000000001
100000000001
100000000001
100000000001
100000000001
100000000001
100000000001
100000000001
100000000001
100000000001
100000000001
111111111101
100000000001
100000000001
101111111111
100000000001
111111111101
100000000001
101111111111
100000000001
111111111101
100000000001
101111111111
100000000001
111111111101
111111111111
