C 104,17,17

F 84,84,84

SO ./textures/south.xpm
EA ./textures/east.xpm
WE ./textures/west.xpm
NO ./textures/north.xpm

111111111111111111111111111111
100000000000000000000000000001
100000000000000000000000000001
100000000000000000000000000001
100000000000000000000000000001
100000000000000000000000000001
100000000000000000000000000001
10000000000000S000000000000001
100000000000001000000000000001
100000000000000000000000000001
100000000000000000000000000001
100000000000000000000000000001
100000000000000000000000000001
100000000000000000000000000001
100000000000000000000000000001
111111111111111111111111111111
