C 104,17,17

F 84,84,84

SO ./textures/south.xpm
EA ./textures/east.xpm
WE ./textures/west.xpm
NO ./textures/north.xpm

111111111111111
100000E00000001
100000000000001
100000000000001
100000001000001
100000000100001
100000001001001
100000000010001
100000000000001
111111111111111
