C 104,17,17
F 84,84,84

NO ./assets/lavawall1.xpm
SO ./assets/lavawall4.xpm
EA ./assets/lavawall2.xpm
WE ./assets/lavawall3.xpm

111111111111111
100000000000001
100000000000001
100N00001000001
100000000000001
100000000000001
100000000000001
111111111111111
